0 0 0 0 0 0 0 0 0 0 0 0 0 0 0 0 0 0 0
0 2 2 3 4 2 3 4 2 3 4 2 3 4 2 3 4 4 0
0 2 2 3 4 2 3 4 2 3 4 2 3 4 2 3 4 4 0
0 5 5 1 6 5 1 6 5 1 6 5 1 6 5 1 6 6 0
0 5 5 1 6 5 1 6 5 1 6 5 1 6 5 1 6 6 0
0 5 5 1 6 5 1 6 5 1 6 5 1 6 5 1 6 6 0
0 5 5 1 6 5 1 6 5 1 6 5 1 6 5 1 6 6 0
0 5 5 1 6 5 1 6 5 1 6 5 1 6 5 1 6 6 0
0 5 5 1 6 5 1 6 5 1 6 5 1 6 5 1 6 6 0
0 5 5 1 6 5 1 6 5 1 6 5 1 6 5 1 6 6 0
0 5 5 1 6 5 1 6 5 1 6 5 1 6 5 1 6 6 0
0 5 5 1 6 5 1 6 5 1 6 5 1 6 5 1 6 6 0
0 5 5 1 6 5 1 6 5 1 6 5 1 6 5 1 6 6 0
0 7 7 8 9 7 8 9 7 8 9 7 8 9 7 8 9 9 0
0 7 7 8 9 7 8 9 7 8 9 7 8 9 7 8 9 9 0
0 0 0 0 0 0 0 0 0 0 0 0 0 0 0 0 0 0 0