0 0 0 0 0 0 0 0 0 0 0 0 0 0 0 0 0 0 0
0 9 8 8 8 8 8 8 8 8 8 8 8 8 8 8 8 7 0
0 6 2 3 4 2 3 4 2 3 4 2 3 4 2 3 4 5 0
0 6 5 1 6 5 1 6 5 1 6 5 1 6 5 1 6 5 0
0 6 5 1 6 5 1 6 5 1 6 5 1 6 5 1 6 5 0
0 6 5 1 6 5 1 6 5 1 6 5 1 6 5 1 6 5 0
0 6 5 1 6 5 1 6 5 1 6 5 1 6 5 1 6 5 0
0 6 5 1 6 5 1 6 5 1 6 5 1 6 5 1 6 5 0
0 6 5 1 6 5 1 6 5 1 6 5 1 6 5 1 6 5 0
0 6 5 1 6 5 1 6 5 1 6 5 1 6 5 1 6 5 0
0 6 5 1 6 5 1 6 5 1 6 5 1 6 5 1 6 5 0
0 6 5 1 6 5 1 6 5 1 6 5 1 6 5 1 6 5 0
0 6 5 1 6 5 1 6 5 1 6 5 1 6 5 1 6 5 0
0 6 7 8 9 7 8 9 7 8 9 7 8 9 7 8 9 5 0
0 4 3 3 3 3 3 3 3 3 3 3 3 3 3 3 3 2 0
0 0 0 0 0 0 0 0 0 0 0 0 0 0 0 0 0 0 0