7 6 6 6 6 6 6 6 6 6 6 6 6 6 6 8
7 1 1 1 1 1 1 1 1 1 1 1 1 1 1 8
7 1 1 2 2 2 2 2 2 2 2 2 2 1 1 8
7 1 3 0 0 0 0 0 0 0 0 0 0 4 1 8
7 1 3 0 0 0 0 0 0 0 0 0 0 4 1 8
7 1 3 0 0 0 0 0 0 0 0 0 0 4 1 8
7 1 3 0 0 0 0 0 0 0 0 0 0 4 1 8
7 1 3 0 0 0 0 0 0 0 0 0 0 4 1 8
7 1 1 5 5 5 5 5 5 5 5 5 5 1 1 8
7 1 1 1 1 1 1 1 1 1 1 1 1 1 1 8
7 9 9 9 9 9 9 9 9 9 9 9 9 9 9 8